%%%%%%%%%%%%%%%%%%%%
%.           ...P .%
%.%%.%%.%%.%%.%% %.%
% %% %.....     o%.%
%%%%%%%%%%%%%%%%%%%%