%%%%%%%%%%%%%%%%%%%%
% Go           .P  %
% %% %% %% %% %% % %
% %% %          o% %
%%%%%%%%%%%%%%%%%%%%
