%%%%%%%%%%%%%%%%%%%%
%o...%........%....%
%.%%.%.%%%%%%.%..%.%
%.%..G.........G.%.%
%.%.%%.%%..%%.%%.%.%
%......%G..G%.%%.%.%
%.%.%%.%%%%%%.%%.%.%
%.%.............G%.%
%o%%o%o%%%%%%o%%%%o%
%....%...P....%....%
%%%%%%%%%%%%%%%%%%%%
