%%%%%%%%%%%%%%%%%%%%
%.Go         ...P .%
%.%%.%%.%%.%%.%% %.%
% %% %.....     o%.%
%%%%%%%%%%%%%%%%%%%%